WWWWWWWWWWWWWWWWWWWWWWWWWWWWWWWWWWWWWWW
W           W           W  W   W      W
W  WWW      W           W    W   W    W
W        WWWW           W             W
W                       WWWWWWWWWW    W
W WW                   WWWWWW         W
WWWW                   W              W
W     WWW              W       WWWWWWWW
W  WWWWWW                      WWW    W
W       W   WWWWWW                    W
W       W           WWW               W
WWWWWWWWW           WWW        WWWWWWWW
W                   WWW               W
WWWWWWWWW                             W
WW           W                        W
WWWWW        WWWW                     W
W                                     W
W                         WWWW        W
W            W        WWWWWWWW        W
W            W            WWWWWWWW    W
W    WWWW    W                        W
W            W                   WWW  W
W  WWWW      WWWWWWWW                 W
WWWWWWWWWWWWWWWWWWWWWWWWWWWWWWWWWWWWWWW